WWWWWWWWWWWWWWWWWWWWWWWW
w                      w
w    www   www  www    w
w    w     w w  w w    w
w    www   w w  www    w
w    w     w w  ww     w
w    w     www  w w    w
w                      w
w                      w
WWWWWWWWWWWWWWWWWWWWWWWW