WWWWWWWWWWWWWWWWWWWWWWWWWWWWWWWWWWWwwwwwwwwwwwwwww
w                                                w
w                                                w
w                                                w
w    wwww    w   w     wwww  w  w   www          w
w    w       ww  w     w  w  w w    w            w
w    wwww    wwwww     wwww  ww     www          w
w       w    w  ww     w  w  w w    w            w
w    wwww    w   w     w  w  w  w   www          w
w                                                w
w                                                w
w                                                w
w                                                w
w                                                w
w                                                w
w                                                w
w                                                w
WWWWWWWWWWWWWWWWWWWWWWWWWWWWWWWWWWWwwwwwwwwwwwwwww