WWWWWWWWWWWWWWWWWWWWWWWWWWWWWWWWWWWWWWWWWWWWWWWWWWWWWWWWWWWWWWWWWWWWWWWWWWWWWW
W                                                                            W
W                                                                            W
W                                                                            W
W                                                                            W
W                                                                            W
W                                                                            W
W                                                                            W
W                                       w                                    W
W                                       w                                    W
W                                       w                                    W
W                                  wwwwwwwwwwww                              W
W                                                                            W
W                                                                            W
W                                                                            W
W                                                                            W
W                                                                            W
W                                                                            W
W                                                                            W
W                                                                            W
W                                                                            W
W                                                                            W
W                                                                            W
W                                                                            W
W                                                                            W
W                                                                            W
W                                                                            W
WWWWWWWWWWWWWWWWWWWWWWWWWWWWWWWWWWWWWWWWWWWWWWWWWWWWWWWWWWWWWWWWWWWWWWWWWWWWWW