WWWWWWWWWWWWWWWWWWWWWWWWWWWWWWWWWWWWWWWWWWWWWWWWWWWWWWWWWWWWWWWWWWWWWWWWWWWWWWWWWWWWWWWWWWW
W                                                                                         W
W                                                                                         W
W                                                                                         W
W                                                                                         W
W                                                                                         W
W                                                                                         W
W                                                                                         W
W                                                                                         W
W                                                                                         W
W         WWWWWWWWWWWWWWWWWWWWWWWWWWWWWWWWWWWWWWWWWWWWWWWWWWWWWWWWWWWWWWWWWWW             W
W                                                                                         W
W                                                                                         W
W                                                                                         W
W                                                                                         W
W                                                                                         W
W                                                                                         W
W                                                                                         W
W                                                                                         W
W                                                                                         W
W                                                                                         W
WWWWWWWWWWWWWWWWWWWWWWWWWWWWWWWWWWWWWWWWWWWWWWWWWWWWWWWWWWWWWWWWWWWWWWWWWWWWWWWWWWWWWWWWWWW